1111111111111111111
1010001000001000001
1011101011101011101
1000100000100000101
1110111111111111101
1010000010000000001
1011111010111111101
1000001000100000101
1010101111101110101
1010101000101010101
1110101010101010101
1000101010001010101
1011111011111010101
1000000000000010001
1111111111111111111